----------------------------------------------------------------------------------------------------------------------------------
----------------------------------------------------------------------------------------------------------------------------------
------------------------------------------------------------------------------------------------------___________-----------------
------------------------------------------------------------------------------------------------------___________-----------------
---------------------------------------___________________________________________________------------__-------________________---
---------------------------------------___________________________________________________------------__-------________________---
---------------------------------------__------__---------------------------------------__------------__---------------------__---
----------------_______________--------__------__---------------------------------------__---___________---------------------__---
----------------_______________--------__------__---------------------------------------__---___g_tt____---------------------__---
----------------__-----------__--------__------g_-----__--------______________----------__---___________---------------------__---
----------------__-----------____________------__-----__--------___g__________----------__---___________---------------------__---
----------------__-----------____________------__-----__--------__----------__----------__-----------------------------------__---
----------------__-----------------------------_________--------__----------__----------__-----------------------------------__---
----------------__-----------------------------_________--------__----------55----------__-----------__________________________---
----------------__----------------------------------------------__--------_______-------__-----------__________________________---
----------------__-----------___!________t____------------------________--___>___-------__-----------88--------------__-----------
----------------__-----------_________________------------------________--_______-------__-----------__--------------__-----------
----------------__--------------------------__-----______-------__----------------------__-----------__--------------__-----------
----------------__--------------------------__-----______-------__----------------------__-----------__--------------__-----------
--------------__________________------------__-----__--__-------__----------------------__-----------__--------------__-----------
--------------__________________------------__---------__-------__________________________-----------__--------------__-----------
--------------__--------------__------------__---------__-------__________________________-----------__--------------__-----------
--------------__--------------__------------__---------__----------------------__--------------------__--------------__-----------
--------------__------__------__------------__---------__----------------------__-----------------__t t___-----------__-----------
--------------__------__------__------------__---------__----------------------__-----------------________-----------__-----------
--------------__________------__------------__---------__________________________-----------------________-----------__-----------
--------------__________------__------------__---------__________________________------------------------------------__-----------
------------------------------__------------__-----------------------------------------------------------------------__-----------
___________-------------------_________________________________________________________________________________________-----------
___________-------------------_________________________________________________________________________________________-----------
___________--------------------------------------------------------------------------__-------------------------------------------
___________--------------------------------------------------------------------------__-------------------------------------------
___________--------------------------------------------------------------------------_--------------------------------------------
___________--------------------------------------------------------------------------(--------------------------------------------
___________-_________________________________________________________________________4___________________________________________-
___________-_____________________________________________________________________________________________________________________-
___________-________________________________________________________________________________________________________------_______-
___________-_________------------------------------------___________________________________________________________------_______-
___________-_________------------------------------------___________________________________________________________------_______-
___________-_________------------------------------------___________________________________________________________------_______-
___________-_________------------------------------------________________________________________________________________________-
___________-_________------------------------------------___________________________________________________________------_______-
___________-_________------------------------------------___________________________________________________________------_______-
___________-_________------------------------------------___________________________________________________________------_______-
___________-________________________________________________________________________________________________________------_______-
___________-_________________________________________________________________________3___________________________________________-
.....................................................................................+............................................
............                  .          .                                  .        9   . ! .              ......................
............                  .          .                                  .            .   .              .                .....
............                 7+          .     ........................     .            .   +           g  +6               .....
............#                 .          .     .!a          .         .     .            .   .      ##      .                .....
............#                 .          .     .           .          .     .            .   .      ##      .                .....
............                  .          .     .          .           .     .            .   .           t  .                .....
............                  .          .     .         .            .     .            .   .              .........+............
............         !!       .          .     .        .                   .     t      ..+..              .                .....
...............................                .       .                                     ................                .....
...............................                .      .                                      ................                .....
...............................                .      .                                      ................      t         .....
..........................................     .                             ............    ................                .....
...............................          .     ............          .......+.               .....................................
...............................          .     .   .                         .               .....................................
...............................          +     .   .                         .               .....................................
...............................          .     .   +                         .               .....................................
...............................          .     .   .                         .       2       .....................................
...............................          .     .   .                                2p2      .....................................
.....................................................................................+............................................
.........................................--------------------------------------------1--------------------------------------------
........................................------------------------------------------------------------------------------------------
..................................................................................................................................
..................................................................................................................................
